84 20
#############GGGGGGGGGGGGGGGGGGGGGGGGGGGGGGGGGGGGGGGGGGGGGGGGGGGGGGGGGGGGGGGGGGGGGG
#...........#GGGGGGGGGGGGGGGGGGGGGGGGGGGGGGGGGGGGGGGGGGGGGGGGGGGGGGGGGGGGGGGGGGGGGG
#...........#######################################################################
#.................................................................................#
#...........######.........a......................................................#
#...........#GGGG#................................................................#
#.....s.....#GGGG#................................................................#
#TTWWWBWWWTT#GGGG#................................................................#
#TTWWWBWWWTT#GGGG#TTTTTTTTTTTTTTTTTTTTTTTTTTTTT.....TTTTTTTTTTTTTTTTTTTTTTTTTTTTTT#
#TTWWWBWWWTT#GGGG#TTTTTTTTTTTTTTTTTTTTTTTTTTTTT.....TTTTTTTTTTTTTTTTTTTTTTTTTTTTTT#
#TTWWWBWWWTT#GGGG#TTTTTTTTTTTTTTTTTTTTTTTTTTTTT.....TTTTTTTTTTTTTTTTTTTTTTTTTTTTTT#
#...........#GGGG#TTTTTTTTTTTTTTTTTTTTTTTTTTTTT.....TTTTTTTTTTTTTTTTTTTTTTTTTTTTTT#
#####...#####GGGG#TTTTTTTTTTTTTTTTTTTTTTTTTTT...o..TTTTTTTTTTTTTTTTTTTTTTTTTTTTTTT#
GG#.......#GGGGGG#TTTTTTTTTTTTTTTTTTTTTTTTTTTTT.....TTTTTTTTTTTTTTTTTTTTTTTTTTTTTT#
GG#.......#GGGGGG#TTTTTTTTTTTTTTTTTTTTTTTTTTTTT.....TTTTTTTTTTTTTTTTTTTTTTTTTTTTTT#
GG#.g.....#GGGGGG#TTTTTTTTTTTTTTTTTTTTTTTTTTTTT.....TTTTTTTTTTTTTTTTTTTTTTTTTTTTTT#
GG#.......#GGGGGG#TTTTTTTTTTTTTTTTTTTTTTTTTTTTT.....TTTTTTTTTTTTTTTTTTTTTTTTTTTTTT#
GG#..@....#GGGGGG#TTTTTTTTTTTTTTTTTTTTTTTTTTTTT.....TTTTTTTTTTTTTTTTTTTTTTTTTTTTTT#
GG#.......#GGGGGG#TTTTTTTTTTTTTTTTTTTTTTTTTTTTT.....TTTTTTTTTTTTTTTTTTTTTTTTTTTTTT#
GG#########GGGGGG################################F#################################
